rows 43
cols 39
players 2

m %%%%%%%%%%%%%%%%%%%%%%%%%%%%%%%%%%%%%%%
m %%%%%...........%%%.%%%...........%%%%%
m %%%%%...........%%%.%%%...........%%%%%
m %%%%%.............................%%%%%
m %%%%%.............................%%%%%
m %%%%%.............................%%%%%
m %%%%%.............................%%%%%
m %%%%%.............................%%%%%
m %%%%%.............................%%%%%
m %%%%%.............................%%%%%
m %%%%%.............................%%%%%
m %%%%%.............................%%%%%
m %%%%%.............................%%%%%
m %%%%%.............................%%%%%
m %%%%%.............................%%%%%
m %%%%%.............bbb.............%%%%%
m %%%%%............bbbbb............%%%%%
m %%%%%............bbBbb............%%%%%
m %%%%%............bbbbb............%%%%%
m %%%%%............%bbb%............%%%%%
m %%%%%.............%%%.............%%%%%
m %%%%%.............................%%%%%
m %%%%%.............%%%.............%%%%%
m %%%%%............%aaa%............%%%%%
m %%%%%............aaaaa............%%%%%
m %%%%%............aaAaa............%%%%%
m %%%%%............aaaaa............%%%%%
m %%%%%.............aaa.............%%%%%
m %%%%%.............................%%%%%
m %%%%%.............................%%%%%
m %%%%%.............................%%%%%
m %%%%%.............................%%%%%
m %%%%%.............................%%%%%
m %%%%%.............................%%%%%
m %%%%%.............................%%%%%
m %%%%%.............................%%%%%
m %%%%%.............................%%%%%
m %%%%%.............................%%%%%
m %%%%%.............................%%%%%
m %%%%%.............................%%%%%
m %%%%%...........%%%.%%%...........%%%%%
m %%%%%...........%%%.%%%...........%%%%%
m %%%%%%%%%%%%%%%%%%%%%%%%%%%%%%%%%%%%%%%
